NO assets/textures/hk/pink/0.xpm	assets/textures/hk/pink/1.xpm	assets/textures/hk/pink/2.xpm	assets/textures/hk/pink/3.xpm	assets/textures/hk/pink/4.xpm	assets/textures/hk/pink/5.xpm	assets/textures/hk/pink/6.xpm	assets/textures/hk/pink/7.xpm	assets/textures/hk/pink/8.xpm	assets/textures/hk/pink/9.xpm
SO assets/textures/hk/real/00.xpm	assets/textures/hk/real/01.xpm	assets/textures/hk/real/02.xpm	assets/textures/hk/real/03.xpm	assets/textures/hk/real/04.xpm	assets/textures/hk/real/05.xpm	assets/textures/hk/real/06.xpm	assets/textures/hk/real/07.xpm	assets/textures/hk/real/08.xpm	assets/textures/hk/real/09.xpm	assets/textures/hk/real/10.xpm	assets/textures/hk/real/11.xpm	assets/textures/hk/real/12.xpm	assets/textures/hk/real/13.xpm	assets/textures/hk/real/14.xpm	assets/textures/hk/real/15.xpm	assets/textures/hk/real/16.xpm	assets/textures/hk/real/17.xpm	assets/textures/hk/real/18.xpm	assets/textures/hk/real/19.xpm	assets/textures/hk/real/20.xpm	assets/textures/hk/real/21.xpm	assets/textures/hk/real/22.xpm	assets/textures/hk/real/23.xpm	assets/textures/hk/real/24.xpm	assets/textures/hk/real/25.xpm	assets/textures/hk/real/26.xpm	assets/textures/hk/real/27.xpm	assets/textures/hk/real/28.xpm	assets/textures/hk/real/29.xpm	assets/textures/hk/real/30.xpm	assets/textures/hk/real/31.xpm
WE assets/textures/hk/cinnamoroll/00.xpm	assets/textures/hk/cinnamoroll/01.xpm	assets/textures/hk/cinnamoroll/02.xpm	assets/textures/hk/cinnamoroll/03.xpm	assets/textures/hk/cinnamoroll/04.xpm	assets/textures/hk/cinnamoroll/05.xpm	assets/textures/hk/cinnamoroll/06.xpm	assets/textures/hk/cinnamoroll/07.xpm	assets/textures/hk/cinnamoroll/08.xpm	assets/textures/hk/cinnamoroll/09.xpm	assets/textures/hk/cinnamoroll/10.xpm	assets/textures/hk/cinnamoroll/11.xpm	assets/textures/hk/cinnamoroll/12.xpm	assets/textures/hk/cinnamoroll/13.xpm	assets/textures/hk/cinnamoroll/14.xpm	assets/textures/hk/cinnamoroll/15.xpm	assets/textures/hk/cinnamoroll/16.xpm	assets/textures/hk/cinnamoroll/17.xpm	assets/textures/hk/cinnamoroll/18.xpm	assets/textures/hk/cinnamoroll/19.xpm
EA assets/textures/hk/beach.xpm

C 178, 209, 255
F 247, 204, 217

                                                         1111
                  111                                11110001111      11111111111
               1111S1111111                         111000000001100111111000000011
              111000000011111111     1111111111111111000000000001111100000000000011
             11000000000000001111111111111111111111100000000000001110000000000000111
            111000000000000000000000000000000000011000000000110000110000000000000011
            110000000000000000000000000000000000110000000111111111111110000000000011
            1100000000000000000000000000000000001100000011100011110000111100111111111
            1100000000000000000000000000000000001100000011100111000000001111100000000111
            1100000000000000000000000000000000001100000001111110000000000111000000000011
            1110100000000000000000000000000000001100000000011110000000000111111000000011
             111100000000000000000000000000000000110000000001110000000000111011100000011
             111000000000000000000000000000000000011111111111111000000001110011100000111
            111000000000000000000000000000000000000000000000000111111111111111110000011
           111000000000000000000000000000000000000000000000000000000001110000000000111
          111000000000000000000000000000000000000000000000000000000000011100000000111
          1100000000000000000000000000000000000000000000000000000000000001111001111111
         11100000000000000000000000000000000000000000000000000000000000000011111000011
         111000000000000000000000000000000000000000000000000000000000000000000000000111
         110000000000000000000000000000000000000000000000000000000000000000000000000111
         110000000000000000000000000000000000000000000000000000000000000000000000000111111111
       111110000000000000000000000000000000000000000000000000000000000000000000111111111
111111111111111100000000000111000000000000000000000000000000000000111000000000000000111
         111000000000000001111100000000000000000000000000000000001111100000000000000111
         111000000000000001111100000000000000000000000000000000001111100000000000000111
          110000000000000011110000000000000000000000000000000000011110000000000001111111111
        111111110000000000000000000000000000011111110000000000000000000000000000000111     11
     11100011100000000000000000000000000000011000001100000000000000000000000000000111
            111000000000000000000000000000000111111100000000000000000000000000000111
              1110111000000000000000000000000000000000000000000000000000000000111111
              1111100000000000000000000000000000000000000000000000000000000000011111111
           1111001111000000000000000000000000000000000000000000000000000000001111     1111
        11100000000111100000000000000000000000000000000000000000000000000001111
                      111110000000000000000000000000000000000000000000011111
                          11111110000000000000000000000000000000001111111
                              111111111111111111111111111111111111111
                                          11111111111111111
