NO ./assets/north.xpm
SO ./assets/east.xpm
WE ./assets/west.xpm
EA ./assets/south.xpm

F         220,       100,63
C         225,    05, 255

11111111111111111111111111111
    1000000000110000000000001111
    1011000001110000000000001
    1001000000000000000000001111
111111111011000001110000000000001
100000000011000001111110111111111
11110111111111011100000010001
11110111111111011101010010001
1100000011010101U100000010001
10000000000000010000000010001
1000000000000111000000010001
1N000000000000011101010010001
1100000111010101110101111000111
11110111 1000101 1011110000011
11111111 1111111 111111111111