NO assets/textures/mc/dirt.xpm
SO assets/textures/mc/grass_block_side.xpm
WE assets/textures/mc/stone.xpm
EA assets/textures/mc/cobblestone.xpm

C 120, 167, 255
F 124, 189, 107

11111
10001
10N01
10001
11111
